####################
#........##........#
#.##.###.##.###.##.#
#..................#
#.##.#.######.#.##.#
#....#...##...#....#
####.###.##.###.####
#....#...##...#....#
#.##.#.######.#.##.#
#..................#
#.##.###.##.###.##.#
#........##........#
########.##.########
#........##........#
#.##.###.##.###.##.#
#..#..........#..#.#
##.#.#.######.#.#.##
#....#...##...#....#
#.######.##.######.#
####################